accetable->acceptable
adresstag->addresstag
affilate->affiliate
authentecated->authenticated
behavior->behaviour
bifinex->bitfinex
canceled->cancelled
candlesctick->candlestick
critcalbankingstuff->criticalbankingstuff
crypo->crypto
cummulative->cumulative
curency->currency
customize->customise
customized->customised
customizes->customises
decerialize->deserialise
decerialized->deserialised
decerializing->deserialising
deserialize->deserialise
deserialized->deserialised
deserializes->deserialises
deserializing->deserialising
favor->favour
generalized->generalised
indivudal->individual
lenging->lending
liquidiation->liquidation
minimize->minimise
minimized->minimised
minimizes->minimises
mmethod->method
openinig->opening
optimize->optimise
optimized->optimised
optimization->optimisation
optimizes->optimises
organize->organise
organized->organised
overrided->overridden
recieve->receive
referal->referral
relationl->relational
retrive->retrieve
serialize->serialise
serialized->serialised
serializes->serialises
serializing->serialising
serparated->separated
snapshooooot->snapshot
sream->stream
suabccount->subaccount
subrcribe->subscribe
summarize->summarise
summarized->summarised
supercritcalinfo->superCriticalInfo
susbsytems->subsystems
umarshal->unmarshal
unreaslied->unrealised
utilize->utilise
utilized->utilised
utilization->utilisation
utilizing->utilising
withdaw->withdraw
withdrawl->withdrawal
